000000000000000000000000000000000000000000000000
000000000000000000000000000000000000000000000000
000000000000000000000000000000000000000000000000
000000000000000000000000000000000000000000000000
000000000000000000000000000000000000000000000000
000000000001100000000000000000000000000000000000
000000000012210000000000000000000000000000000000
111111111122221111111111111111111111111111111111
222222222222222222222222222222222222222222222222