  0,  0,  0,  0,  0,  0,  0,  0,  0,  0,  0,  0,  0,  0,  0,  0,  0,  0,  0,  0,  0,  0,  0,  0,  0,  0,  0,  0,  0,  0,  0,  0,  0,  0,  0,  0,  0,  0,  0,  0,  0,  0,  0,  0,  0,  0,  0,  0,  0,  0,  0,  0,  0,  0,  0,  0,  0,  0,  0,  0,  0,  0,  0,  0,  0,  0,  0,  0,  0,  0,  0,  0,  0,  0,  0,  0,  0,  0,  0,  0,  0,  0,  0,  0,  0,  0,  0,  0,  0,  0, 23, 23, 23, 23, 23, 23, 23, 23, 23, 23, 23, 23, 23, 23, 23, 23, 23, 23, 23, 23, 23, 23, 23, 23, 23, 23, 23, 23, 23, 23, 23,  0,  0,  0,  0,  0,  0,  0,  0,  0,  0,  0,  0,  0,  4,  4,  4,  4,  0,  0,  0,  0,  0,  0,  0,  0,  0,  0,  0,  0,  0,  0,  0,  0,  0,  0,  0,  0
  0,  0,  0,  0,  0,  0,  0,  0,  0,  0,  0,  0,  0,  0,  0,  0,  0,  0,  0,  0,  0,  0,  0,  0,  0,  0,  0,  0,  0,  0,  0,  0,  0,  0,  0,  0,  0,  0,  0,  0,  0,  0,  0,  0,  0,  0,  0,  0,  0,  0,  0,  0,  0,  0,  0,  0,  0,  0,  0,  0,  0,  0,  0,  0,  0,  0,  0,  0,  0,  0,  0,  0,  0,  0,  0,  0,  0,  0,  0,  0,  0,  0,  0,  0,  0,  0,  0,  0,  0,  0, 23, 23,  0,  0,  0,  0,  0,  0,  0,  0,  0,  0,  0,  0,  0,  0, 23,  0,  0,  0,  0, 23,  0,  0,  0,  0,  0,  0,  0,  0,  0,  0,  0,  0,  0,  0,  0,  0,  0,  0,  0,  0,  0,  0,  4,  4,  4,  4,  0,  0,  0,  0,  0,  0,  0,  0,  0,  0,  0,  0,  0,  0,  0,  0,  0,  0,  0,  0
  0,  0,  0,  0,  0,  0,  0,  0,  0,  0,  0,  0,  0,  0,  0,  0,  0,  0,  0,  0,  0,  0,  0,  0,  0,  0,  0,  0,  0,  0,  0,  0,  0,  0,  0,  0,  0,  0,  0,  0,  0,  0,  0,  0,  0,  0,  0,  0,  0,  0,  0,  0,  0,  0,  0,  0,  0,  0,  0,  0,  0,  0,  0,  0,  0,  0,  0,  0,  0,  0,  0,  0,  0,  0,  0,  0,  0,  0,  0,  0,  0,  0,  0,  0,  0,  0,  0,  0,  0,  0, 23, 23,  0,  0,  0,  0,  0,  0,  0,  0,  0,  0,  0,  0,  0,  0, 23,  0,  0,  0,  0, 23, 23,  0,  0,  0,  0,  0,  0,  0,  0,  0,  0,  0,  0,  0,  0,  0,  0,  0,  0,  0,  0,  0,  4,  4,  4,  4,  0,  0,  0,  0,  0,  0,  0,  0,  0,  0,  0,  0,  0,  0,  0,  0,  0,  0,  0,  0
  0,  0,  0,  0,  0,  0,  0,  0,  0,  0,  0,  0,  0,  0,  0,  0,  0,  0,  0,  0,  0,  0,  0,  0,  0,  0,  0,  0,  0,  0,  0,  0,  0,  0,  0,  0,  0,  0,  0,  0,  0,  0,  0,  0,  0,  0,  0,  0,  0,  0,  0,  0,  0,  0,  0,  0,  0,  0,  0,  0,  0,  0,  0,  0,  0,  0,  0,  0,  0,  0,  0,  0,  0,  0,  0,  0,  0,  0,  0,  0,  0,  0,  0,  0,  0,  0,  0,  0,  0,  0, 23, 23,  0,  0,  0,  0,  0,  0,  0,  0,  0,  0,  0,  0,  0,  0, 23,  0,  0,  0,  0,  0, 23, 23, 23, 23, 23, 23, 23, 23,  0,  0,  0,  0,  0,  0,  0,  0,  0,  2,  0,  0,  0,  0,  4,  4,  4,  4,  0,  0,  0,  0,  0,  0,  0,  0,  0,  0,  0,  0,  0,  0,  0,  0,  0,  0,  0,  0
  0,  0,  0,  0,  0,  0,  0,  0,  0,  0,  0,  0,  0,  0,  0,  0,  0,  0,  0,  0,  0,  0,  0,  0,  0,  0,  0,  0,  0,  0,  0,  0,  0,  0,  0,  0,  0,  0,  0,  0,  0,  0,  0,  0,  0,  0,  0,  0,  0,  0,  0,  0,  0,  0,  0,  0,  0,  0,  0,  0,  0,  0,  0,  0,  0,  0,  0,  0,  0,  0,  0,  0,  0,  0,  0,  0,  0,  0,  0,  0,  0,  0,  0,  0,  0,  0,  0,  0,  0,  0, 23, 23,  0,  0,  0,  0,  0,  0,  0,  0,  0,  0,  0,  0,  0, 23, 23, 23,  0,  0,  0,  0,  0,  0,  0,  0,  0,  0,  0, 72,  0,  0,  0,  0,  0,  0,  0,  0,  2,  4,  0,  0,  0,  0,  4,  4,  4,  4,  0,  0,  0,  0,  0,  0,  0,  0,  0,  0,  0,  0,  0,  0,  0,  0,  0,  0,  0,  0
  0,  0,  0,  0,  0,  0,  0,  0,  0,  0,  0,  0,  0,  0,  0,  0,  0,  0,  0,  0,  0,  0,  0,  0,  0,  0,  0,  0,  0,  0,  0,  0,  0,  0,  0,  0,  0,  0,  0,  0,  0,  0,  0,  0,  0,  0,  0,  0,  0,  0,  0,  0,  0,  0,  0,  0,  0,  0,  0,  0,  0,  0,  0,  0,  0,  0,  0,  0,  0,  0,  0,  0,  0,  0,  0,  0,  0,  0,  0,  0,  0,  0,  0,  0,  0,  0,  0,  0,  0,  0, 23, 23,  0,  0,  0,  0,  0,  0,  0,  0,  0,  0, 23, 23, 23, 23,  0, 23, 23, 23, 23, 23, 23, 23, 23,  0,  0,  0,  0,  0,  0,  0,  0,  0,  0,  0,  0,  2,  4,  4,  0,  0,  0,  0,  4,  4,  4,  4,  0,  0,  0,  0,  0,  0,  0,  0,  0,  0,  0,  0,  0,  0,  0,  0,  0,  0,  0,  0
  0,  0,  0,  0,  0,  0,  0,  0,  0,  0,  0,  0,  0,  0,  0,  0,  0,  0,  0,  0,  0,  0,  0,  0,  0,  0,  0,  0,  0,  0,  0,  0,  0,  0,  0,  0,  0,  0,  0,  0,  0,  0,  0,  0,  0,  0,  0,  0,  0,  0,  0,  0,  0,  0,  0,  0,  0,  0,  0,  0,  0,  0,  0,  0,  0,  0,  0,  0,  0,  0,  0,  0,  0,  0,  0,  0,  0,  0,  0,  0,  0,  0,  0,  0,  0,  0,  0,  0,  0,  0, 23, 23,  0,  0,  0,  0,  0,  0,  0,  0,  0, 23, 23,  0,  0,  0,  0,  0, 71,  0,  0,  0,  0,  0, 72,  0,  0,  0,  0,  0,  0,  0,  0,  0,  0,  2,  1,  4,  4,  4,  0,  0,  0,  0,  4,  4,  4,  4,  0,  0,  0, 23, 23,  0,  0,  0,  0,  0,  0,  0,  0,  0,  0,  0,  0,  0,  0,  0
  0,  0,  0,  0,  0,  0,  0,  0,  0,  0,  0,  0,  0,  0,  0,  0,  0,  0,  0,  0,  0,  0,  0,  0,  0,  0,  0,  0,  0,  0,  0,  0,  0,  0,  0,  0,  0,  0,  0,  0,  0,  0,  0,  0,  0,  0,  0,  0,  0,  0,  0,  0,  0,  0,  0,  0,  0,  0,  0,  0,  0,  0,  0,  0,  0,  0,  0, 23, 23,  0,  0,  0,  0,  0,  0,  0,  0,  0,  0,  0,  0,  0,  0,  0,  0,  0,  0,  0,  0,  0, 23, 23,  0,  0,  0,  0,  0,  0,  0,  0,  0,  0,  0,  0,  0,  0,  0,  0, 71,  0,  0,  0,  0,  0,  0,  0,  0,  0,  0,  0,  0,  0,  2,  1,  1,  4,  4,  4,  4,  4,  0,  0,  0,  0,  4,  4,  4,  4,  0,  0,  0, 23, 23,  0,  0,  0,  0,  0,  0,  0,  0,  0,  0,  0,  0,  0,  0,  0
  0,  0,  0,  0,  0,  0,  0,  0,  0,  0,  0,  0,  0,  0,  0,  0,  0,  0,  0,  0,  0,  0,  0,  0,  0,  0,  0,  0,  0,  0,  0,  0,  0,  0,  0,  0,  0,  0,  0,  0,  0,  0,  0,  0,  0,  0,  0,  0,  0,  0,  0,  0,  0,  0,  0,  0,  0,  0,  0,  0,  0,  0,  0,  0,  0,  0,  0, 23, 23,  0,  0,  0,  0,  0,  0,  0,  0,  0,  0,  0,  0,  0,  0,  0,  0,  0,  0,  0, 23, 23, 23, 23,  0,  0,  0,  0,  0,  0,  0,  0,  0,  0,  0,  0,  0,  0,  0,  0, 72,  0,  0,  0,  0,  0,  0,  0,  0,  0,  0,  0,  1,  1,  4,  4,  4,  4,  4,  4,  4,  4,  0,  0,  0,  0,  4,  4,  4,  4,  0,  0,  0, 23, 23, 23, 23, 23, 23, 23,  0,  0,  0,  0,  0,  0,  0,  0,  0,  0
  0,  0,  0,  0,  0,  0,  0,  0,  0, 23, 23, 23, 23, 23, 23, 23, 23, 23, 23, 23, 23, 23, 23, 23, 23, 23, 23, 23, 23,  0,  0,  0, 23, 23, 23, 23, 23, 23, 23, 23, 23, 23, 23, 23, 23, 23, 23, 23, 23, 23, 23, 23, 23, 23, 23,  0,  0,  0, 23, 23, 23, 23, 23, 23, 23, 23, 23, 23, 23, 23, 23, 23, 23,  0,  0,  0,  0, 23, 23, 23, 23, 23, 23, 23, 23, 23, 23, 23, 23, 23, 23, 23, 23, 23, 23, 23, 23, 23, 23, 23, 23, 23,  0,  0,  0,  0,  0,  0,  0,  0,  0,  0,  0,  0,  0,  0,  0,  0,  2,  1,  4,  4,  4,  4,  4,  4,  4,  4,  4,  4,  0,  0,  0,  0, 23, 23, 23, 23, 23, 23, 23, 23, 23,  0, 91,  0,  0,  0,  0,  0,  0,  0,  0,  0,  0,  0,  0,  0
  0,  0,  0,  0,  0,  0,  0,  0,  0,  0,  0,  0,  0,  0, 23, 23,  0,  0,  0, 71,  0,  0,  0,  0, 91,  0,  0,  0, 71,  0,  0,  0,  0,  0,  0,  0, 23, 23,  0,  0, 91,  0,  0,  0,  0, 71,  0,  0,  0,  0,  0,  0,  0, 71,  0,  0,  0,  0,  0,  0,  0,  0, 91,  0,  0,  0,  0, 23, 23,  0,  0, 91,  0,  0,  0,  0,  0,  0, 72,  0,  0,  0,  0,  0, 91, 23, 23,  0,  0,  0, 23, 23,  0,  0, 71,  0,  0,  0,  0,  0,  0, 72,  0,  0,  0,  0,  0,  0,  0,  0,  0,  0,  0,  0,  0,  0,  2,  1,  4,  4,  4,  4,  4,  4,  4,  4,  4,  4,  4,  4,  0,  0,  0,  0,  0, 72,  0,  0,  0, 91,  0, 23, 23,  0,  0,  0,  0,  0,  0,  0,  0,  0,  0,  0,  0,  0,  0,  0
  0,  0,  0,  0,  0,  0,  0,  0,  0,  0,  0,  0,  0,  0, 23, 23,  0,  0,  0, 71,  0,  0,  0,  0,  0,  0,  0,  0, 71,  0,  0,  0,  0,  0,  0,  0, 23, 23,  0,  0,  0,  0,  0,  0,  0, 71,  0,  0,  0,  0,  0,  0,  0, 71,  0,  0,  0,  0,  0,  0,  0,  0,  0,  0,  0,  0,  0, 23, 23,  0,  0,  0,  0,  0,  0,  0,  0,  0,  0,  0,  0,  0,  0,  0,  0, 23, 23,  0,  0,  0, 23, 23,  0,  0, 72,  0,  0,  0,  0,  0,  0,  0,  0,  0,  0,  0,  0,  0,  0,  0,  0,  0,  0,  0,  2,  1,  4,  4,  4,  4,  4,  4,  4,  4,  4,  4,  4,  4,  4,  4,  0,  0,  0,  0,  0,  0,  0,  0,  0,  0,  0, 23, 23,  0,  0,  0,  0,  0,  0,  0,  0,  0,  0,  0,  0,  0,  0,  0
  0,  0,  0,  0,  0,  0,  0,  0,  0,  0,  0,  0,  0,  0, 23, 23,  0,  0,  0, 71,  0,  0,  0,  0,  0,  0,  0,  0, 71,  0,  0,  0,  0,  0,  0,  0, 23, 23,  0,  0,  0,  0,  0,  0,  0, 71,  0,  0,  0,  0,  0,  0,  0, 71,  0,  0,  0,  0,  0,  0,  0,  0,  0,  0,  0,  0,  0, 23, 23,  0,  0,  0,  0,  0,  0,  0,  0,  0,  0,  0,  0,  0,  0,  0,  0, 23, 23,  0,  0,  0, 23, 23,  0,  0,  0,  0,  0,  0,  0,  0,  0,  0,  0,  0,  0,  0,  0,  0,  0,  0,  0,  2,  1,  1,  4,  4,  4,  4,  4,  4,  4,  4,  4,  4,  4,  4,  4,  4,  4,  4,  0,  0,  0,  0,  0,  0,  0,  0,  0,  0,  0, 23, 23,  0,  0,  0,  0,  0,  0,  0,  0,  0,  0, 85, 86,  0,  0,  0
  0,  0,  0,  0,  0,  0,  0,  0,  0,  0,  0,  0,  0,  0, 23, 23,  0,  0,  0, 72,  0,  0,  0,  0,  0,  0,  0,  0, 72,  0,  0,  0,  0,  0,  0,  0, 23, 23,  0,  0,  0,  0,  0,  0,  0, 72,  0,  0,  0,  0,  0,  0,  0, 72,  0,  0,  0,  0,  0,  0,  0,  0,  0,  0,  0,  0,  0, 23, 23,  0,  0,  0,  0,  0,  0,  0,  0,  0,  0,  0,  0,  0,  2,  1,  1,  1,  1,  1,  0,  0, 23, 23,  0,  0,  0,  0,  0,  0,  0,  0,  0,  0,  0,  0,  0,  0,  0,  2,  1,  1,  1,  4,  4,  4,  4,  4,  4,  4,  4,  4,  4,  4,  4,  4,  4,  4,  4,  4,  4,  4,  0, 97,  0,  0,  0,  0,  0,  0,  0,  0,  0, 23, 23,  0,  0,  0,  0,  0,  0,  0,  0,  0,  0, 87, 88,  0,  0,  0
  0,  0,  0,  0,  0,  0,  0,  0,  0,  0,  0,  0,  0,  0, 23, 23,  0,  0,  0,  0,  0,  0,  0,  0,  0,  0,  0,  0,  0,  0,  0,  0,  0,  0,  0,  0, 23, 23,  0,  0,  0,  0,  0,  0,  0,  0,  0,  0,  0,  0,  0,  0,  0,  0,  0,  0,  0,  0,  0,  0,  0,  0,  0,  0,  0,  2,  1,  1,  1,  1,  1,  1,  1,  1,  0,  0,  0,  0,  0,  0,  0,  2,  4,  4,  4,  4,  4,  4,  0,  0, 23, 23,  0,  0,  0,  0,  0,  0,  0,  0,  0,  0,  0,  2,  1,  1,  1,  4,  4,  4,  4,  4,  4,  4,  4,  4,  4,  4,  4,  4,  4,  4,  4,  4,  4,  4,  4,  4,  4,  4,  1, 69,  1,  1,  1,  1,  1,  1,  1,  1,  1,  1,  1,  1,  1,  1,  1,  1,  1,  1,  1,  1,  1,  1,  1,  1,  1,  1
  0,  0,777,  0,  0,  0,  0,  0,  0,  0,  0,  0,  0,  0, 23, 23,  0,  0,  0,  0,  0,  0,  0,  0,  0,  0,  0,  0,  0,  0,  0,  0,  0,  0,  0,  0, 23, 23,  0,  0,  0,  0,  0,  0,  0,  0,  0,  0,  0,  0,  0,  0,  0,  0,  0,  0,  0,  0,  0,  0,  0,  0,  0,  2,  1,  4,  4,  4,  4,  4,  4,  4,  4,  4,  0,  0,  0,  0,  0,  0,  2,  4,  4,  4,  4,  4,  4,  4, 68,  0, 23, 23,  0,  0,  0,  0,  0,  0,  0,  2,  1,  1,  1,  4,  4,  4,  4,  4,  4,  4,  4,  4,  4,  4,  4,  4,  4,  4,  4,  4,  4,  4,  4,  4,  4,  4,  4,  4,  4,  4,  4, 69,  4,  4,  4,  4,  4,  4,  4,  4,  4,  4,  4,  4,  4,  4,  4,  4,  4,  4,  4,  4,  4,  4,  4,  4,  4,  4
  1,  1,  1,  1,  1,  1,  1,  0,  0,  1,  1,  0,  0,  1,  1,  1,  1,  0,  0,  0,  0,  0,  1,  1,  1,  1,  1,  0,  0,  0,  0,  0,  0,  1,  1,  1,  1,  1,  1,  1,  1,  1,  1,  0,  0,  0,  0,  0,  0,  0,  0,  0,  0,  0,  0,  0,  0,  1,  1,  1,  1,  1,  1,  4,  4,  4,  4,  4,  4,  4,  4,  4,  4,  4,  1,  1,  1,  1,  1,  1,  4,  4,  4,  4,  4,  4,  4,  4, 69,  1,  1,  1,  1,  1,  1,  1,  1,  1,  1,  4,  4,  4,  4,  4,  4,  4,  4,  4,  4,  4,  4,  4,  4,  4,  4,  4,  4,  4,  4,  4,  4,  4,  4,  4,  4,  4,  4,  4,  4,  4,  4, 69,  4,  4,  4,  4,  4,  4,  4,  4,  4,  4,  4,  4,  4,  4,  4,  4,  4,  4,  4,  4,  4,  4,  4,  4,  4,  4
  4,  4,  4,  4,  4,  4,  4,  0,  0,  4,  4,  0,  0,  4,  4,  4,  4,  0,  0,  0,  0,  0,  4,  4,  4,  4,  4,  0,  0,  0,  0,  0,  0,  4,  4,  4,  4,  4,  4,  4,  4,  4,  4,  0,  0,  0,  0,  0,  0,  0,  0,  0,  0,  0,  0,  0,  0,  4,  4,  4,  4,  4,  4,  4,  4,  4,  4,  4,  4,  4,  4,  4,  4,  4,  4,  4,  4,  4,  4,  4,  4,  4,  4,  4,  4,  4,  4,  4, 69,  4,  4,  4,  4,  4,  4,  4,  4,  4,  4,  4,  4,  4,  4,  4,  4,  4,  4,  4,  4,  4,  4,  4,  4,  4,  4,  4,  4,  4,  4,  4,  4,  4,  4,  4,  4,  4,  4,  4,  4,  4,  4, 69,  4,  4,  4,  4,  4,  4,  4,  4,  4,  4,  4,  4,  4,  4,  4,  4,  4,  4,  4,  4,  4,  4,  4,  4,  4,  4
  4,  4,  4,  4,  4,  4,  4,  0,  0,  4,  4,  0,  0,  4,  4,  4,  4, -1, -1, -1, -1, -1,  4,  4,  4,  4,  4, -1, -1, -1, -1, -1, -1,  4,  4,  4,  4,  4,  4,  4,  4,  4,  4, -1, -1, -1, -1, -1, -1, -1, -1, -1, -1, -1, -1, -1, -1,  4,  4,  4,  4,  4,  4,  4,  4,  4,  4,  4,  4,  4,  4,  4,  4,  4,  4,  4,  4,  4,  4,  4,  4,  4,  4,  4,  4,  4, 25,  0,  0,  0,  0,  0,  0,  0,  0,  4,  4,  4,  4,  4,  0,  0,  0,  0,  0,  0,  0,  4,  0,  0,  0,  0,  0,  4,  4,  4,  4,  4,  4,  4,  0,  0,  0,  0,  0,  4,  4,  0,  0,  0,  0,  0, 25,  4,  4,  4,  4,  4,  4,  4,  4,  4,  4,  4,  4,  4,  4,  4,  4,  4,  4,  4,  4,  4,  4,  4,  4,  4
  4,  4,  4,  4,  4,  4,  4, -1, -1,  4,  4, -1, -1,  4,  4,  4,  4,  4,  4,  4,  4,  4,  4,  4,  4,  4,  4,  4,  4,  4,  4,  4,  4,  4,  4,  4,  4,  4,  4,  4,  4,  4,  4, -1, -1, -1, -1, -1, -1, -1, -1, -1, -1, -1, -1, -1, -1,  4,  4,  4,  4,  4,  4,  4,  4,  4,  4,  4,  4,  4,  4,  4,  4,  4,  4,  4,  4,  4,  4,  4,  4,  4,  4,  4,  4,  4, 25,  0,  0,  0,  0,  0,  0,  0,  0,  0,  4,  4,  0,  4,  0,  0,  0,  0,  0,  0,  0,  4,  0,  0,  0,  0,  0,  0,  4,  0,  0,  4,  0,  0,  0,  0,  0,  0,  0,  0,  0,  0,  0,  0,  0,  0, 25,  4,  4,  4,  4,  4,  4,  4,  4,  4,  4,  4,  4,  4,  4,  4,  4,  4,  4,  4,  4,  4,  4,  4,  4,  4
  4,  4,  4,  4,  4,  4,  4, -1, -1,  4,  4, -1, -1,  4,  4,  4,  4,  4,  4,  4,  4,  4,  4,  4,  4,  4,  4,  4,  4,  4,  4,  4,  4,  4,  4,  4,  4,  4,  4,  4,  4,  4,  4, -1, -1, -1, -1, -1, -1, -1, -1, -1, -1, -1, -1, -1, -1,  4,  4,  4,  4,  4,  4,  4,  4,  4,  4,  4,  4,  4,  4,  4,  4,  4,  4,  4,  4,  4,  4,  4,  4,  4,  4,  4,  4,  4, 25,  0,  0,  0,  0,  0, 25, 25,  0,  0,  0,  0,  0,  4,  4,  0,  0,  0, 25,  0,  0,  4,  0,  0,  0, 25,  0,  0,  4,  0,  0,  0,  0,  0,  0,  0, 25,  0,  0,  0,  0,  0, 25,  0,  0,  0, 25,  4,  4,  4,  4,  4,  4,  4,  4,  4,  4,  4,  4,  4,  4,  4,  4,  4,  4,  4,  4,  4,  4,  4,  4,  4
  4,  4,  4,  4,  4,  4,  4, -1, -1,  4,  4, -1, -1,  4,  4,  4,  4,  4,  4,  4,  4,  4,  4,  4,  4,  4,  4,  4,  4,  4,  4,  4,  4,  4,  4,  4,  4,  4,  4,  4,  4,  4,  4, -1, -1, -1, -1, -1, -1, -1, -1, -1, -1, -1, -1, -1, -1,  4,  4,  4,  4,  4,  4,  4,  4,  4,  4,  4,  4,  4,  4,  4,  4,  4,  4,  4,  4,  4,  4,  4,  4,  4,  4,  4,  4,  4, 25,  0,  0,  0,  0, 25, 25, 25, 25,  0,  0,  0,  0,  0,  0,  0,  0, 25, 25,  0,  0,  0,  0,  0, 25, 25,  0,  0,  0,  0,  0, 25, 25,  0,  0, 25, 25,  0,  0, 25, 25, 25, 25,  0,  0,  0, 25,  4,  4,  4,  4,  4,  4,  4,  4,  4,  4,  4,  4,  4,  4,  4,  4,  4,  4,  4,  4,  4,  4,  4,  4,  4
  4,  4,  4,  4,  4,  4,  4, -1, -1,  4,  4, -1, -1,  4,  4,  4,  4,  4,  4,  4,  4,  4,  4,  4,  4,  4,  4,  4,  4,  4,  4,  4,  4,  4,  4,  4,  4,  4,  4,  4,  4,  4,  4, -1, -1, -1, -1, -1, -1, -1, -1, -1, -1, -1, -1, -1, -1,  4,  4,  4,  4,  4,  4,  4,  4,  4,  4,  4,  4,  4,  4,  4,  4,  4,  4,  4,  4,  4,  4,  4,  4,  4,  4,  4,  4,  4, 25, 25, 25, 25, 25, 25, 25, 25, 25, 25, 25, 25, 25, 25, 25, 25, 25, 25, 25, 25, 25, 25, 25, 25, 25, 25, 25, 25, 25, 25, 25, 25, 25, 25, 25, 25, 25, 25, 25, 25, 25, 25, 25, 25, 25, 25, 25,  4,  4,  4,  4,  4,  4,  4,  4,  4,  4,  4,  4,  4,  4,  4,  4,  4,  4,  4,  4,  4,  4,  4,  4,  4